10
10
0xxxxxxxx0
x00000x11x
x00000x11x
xr0000011x
x00000xxxx
x00000000x
xxxxx0000x
x111x0000x
x11111000x
0xxxxxxxx0