10
10
0000020000
000000000x
0r02000000
xxxx000000
0000100000
00000xx000
000000xx00
0xx0000xxx
03x0000010
00x0001000